13 26
##########################
########................##
#S........##......###....#
######@...#########......#
##...............#####...#
##........##..........####
##........##........######
##.......#X.#...........##
##.......#..#...........##
##...............####....#
##.........###...........#
##..........##...........#
##########################